date,new,NTotal_ExposureOnly,domestic-contactWithCase,domestic-contactWithTraveller,domestic-unknown,internationalTravel,infopending,cumulative,cumulativeNTotal_ExposureOnly,doubleFlagTest,shaded
2020-01-15,1,1,0,0,0,1,0,1,1,1,14
2020-01-16,1,1,0,0,0,0,1,2,2,1,
2020-01-17,0,0,0,0,0,0,0,2,2,0,
2020-01-18,1,1,0,0,1,0,0,3,3,0,
2020-01-19,0,0,0,0,0,0,0,3,3,0,
2020-01-20,0,0,0,0,0,0,0,3,3,0,
2020-01-21,1,1,0,0,0,1,0,4,4,1,
2020-01-22,2,2,0,0,0,2,0,6,6,0,
2020-01-23,0,0,0,0,0,0,0,6,6,0,
2020-01-24,2,2,1,0,0,1,0,8,8,1,
2020-01-25,0,0,0,0,0,0,0,8,8,0,
2020-01-26,0,0,0,0,0,0,0,8,8,0,
2020-01-27,1,1,1,0,0,0,0,9,9,0,
2020-01-28,1,1,0,0,0,1,0,10,10,0,
2020-01-29,0,0,0,0,0,0,0,10,10,0,
2020-01-30,0,0,0,0,0,0,0,10,10,0,
2020-01-31,1,1,0,0,1,0,0,11,11,0,
2020-02-01,2,2,0,0,1,1,0,13,13,0,
2020-02-02,1,0,0,0,0,0,0,14,13,0,
2020-02-03,1,1,0,0,1,0,0,15,14,0,
2020-02-04,2,2,0,0,2,0,0,17,16,1,
2020-02-05,2,2,0,0,1,1,0,19,18,0,
2020-02-06,0,0,0,0,0,0,0,19,18,0,
2020-02-07,1,1,1,0,0,0,0,20,19,0,
2020-02-08,0,0,0,0,0,0,0,20,19,0,
2020-02-09,1,1,0,0,0,1,0,21,20,0,
2020-02-10,2,2,0,0,1,1,0,23,22,0,
2020-02-11,0,0,0,0,0,0,0,23,22,0,
2020-02-12,1,1,0,0,1,0,0,24,23,0,
2020-02-13,1,1,0,0,0,1,0,25,24,0,
2020-02-14,4,4,0,0,2,2,0,29,28,0,
2020-02-15,2,2,1,0,0,1,0,31,30,0,
2020-02-16,1,1,0,0,0,1,0,32,31,0,
2020-02-17,2,2,1,0,0,1,0,34,33,1,
2020-02-18,2,2,2,0,0,0,0,36,35,0,
2020-02-19,3,3,1,0,1,1,0,39,38,0,
2020-02-20,7,7,3,1,1,2,0,46,45,0,
2020-02-21,2,2,0,0,0,2,0,48,47,0,
2020-02-22,5,5,0,0,2,3,0,53,52,0,
2020-02-23,16,16,7,0,2,7,0,69,68,1,
2020-02-24,14,14,3,0,2,9,0,83,82,0,
2020-02-25,15,15,3,0,2,10,0,98,97,0,
2020-02-26,12,12,6,1,3,2,0,110,109,0,
2020-02-27,25,25,13,0,6,6,0,135,134,0,
2020-02-28,35,35,19,0,4,12,0,170,169,1,
2020-02-29,27,27,9,0,4,13,1,197,196,0,
2020-03-01,48,48,13,0,15,19,1,245,244,0,
2020-03-02,48,48,8,0,10,30,0,293,292,0,
2020-03-03,53,53,17,0,8,28,0,346,345,1,
2020-03-04,51,50,16,1,8,25,0,397,395,0,
2020-03-05,63,63,14,1,17,31,0,460,458,0,
2020-03-06,83,83,18,2,22,40,1,543,541,0,
2020-03-07,89,89,17,3,27,42,0,632,630,0,
2020-03-08,131,131,33,3,35,58,2,763,761,1,
2020-03-09,224,224,69,10,56,89,0,987,985,0,
2020-03-10,257,257,65,8,64,119,1,1244,1242,0,
2020-03-11,297,297,86,11,73,122,5,1541,1539,1,
2020-03-12,383,383,107,8,114,152,2,1924,1922,0,
2020-03-13,456,454,136,10,141,166,1,2380,2376,0,
2020-03-14,458,454,101,14,162,174,3,2838,2830,0,
2020-03-15,599,596,169,11,189,223,4,3437,3426,1,
2020-03-16,837,834,270,10,291,261,2,4274,4260,0,
2020-03-17,865,861,280,17,300,258,6,5139,5121,0,
2020-03-18,957,954,290,19,335,301,9,6096,6075,0,
2020-03-19,810,802,271,12,279,231,9,6906,6877,1,
2020-03-20,1018,1015,376,23,390,221,5,7924,7892,0,
2020-03-21,891,883,327,11,301,237,7,8815,8775,0,
2020-03-22,867,866,343,13,319,186,5,9682,9641,0,
2020-03-23,1064,1061,460,17,407,168,9,10746,10702,0,
2020-03-24,958,951,407,21,354,165,4,11704,11653,0,
2020-03-25,974,972,469,13,369,113,8,12678,12625,0,
2020-03-26,906,904,455,14,320,109,6,13584,13529,0,
2020-03-27,951,943,494,8,352,80,9,14535,14472,1,
2020-03-28,956,947,524,8,328,82,5,15491,15419,0,
2020-03-29,864,859,499,9,295,52,4,16355,16278,0,
2020-03-30,1136,1133,641,11,407,70,4,17491,17411,0,
2020-03-31,960,956,570,3,313,64,6,18451,18367,0,
2020-04-01,1297,1288,814,13,374,80,7,19748,19655,0,
2020-04-02,1157,1154,807,11,290,41,5,20905,20809,0,
2020-04-03,1331,1329,952,7,318,51,1,22236,22138,0,
2020-04-04,1150,1149,836,9,266,31,7,23386,23287,0,
2020-04-05,1066,1065,753,5,283,19,5,24452,24352,0,
2020-04-06,1407,1402,949,11,422,14,6,25859,25754,0,
2020-04-07,1277,1275,869,13,372,18,3,27136,27029,0,
2020-04-08,1406,1405,987,10,397,5,6,28542,28434,0,
2020-04-09,1465,1462,1018,14,424,5,1,30007,29896,1,
2020-04-10,1737,1736,1233,19,470,6,8,31744,31632,0,
2020-04-11,1626,1625,1124,11,484,3,3,33370,33257,0,
2020-04-12,1478,1476,1052,16,395,5,8,34848,34733,0,
2020-04-13,2034,2032,1279,32,706,6,9,36882,36765,0,
2020-04-14,1781,1780,1211,21,542,3,3,38663,38545,0,
2020-04-15,1873,1870,1326,21,513,4,6,40536,40415,0,
2020-04-16,1940,1938,1303,18,613,1,3,42476,42353,0,
2020-04-17,1871,1870,1314,17,536,3,0,44347,44223,0,
2020-04-18,1668,1666,1206,21,435,3,1,46015,45889,0,
2020-04-19,1267,1266,865,15,377,4,5,47282,47155,0,
2020-04-20,1810,1808,1210,11,579,3,5,49092,48963,0,
2020-04-21,1435,1434,925,13,488,4,4,50527,50397,0,
2020-04-22,1548,1547,1004,12,525,2,4,52075,51944,0,
2020-04-23,1572,1571,1014,20,533,1,3,53647,53515,0,
2020-04-24,1509,1507,973,10,517,3,4,55156,55022,0,
2020-04-25,1409,1405,938,15,443,5,4,56565,56427,0,
2020-04-26,1345,1345,892,13,430,4,6,57910,57772,0,
2020-04-27,1673,1672,1048,11,605,5,3,59583,59444,0,
2020-04-28,1515,1515,973,19,513,6,4,61098,60959,1,
2020-04-29,1490,1490,889,4,589,2,6,62588,62449,0,
2020-04-30,1449,1449,899,5,539,3,3,64037,63898,0,
2020-05-01,1589,1588,958,8,615,4,3,65626,65486,0,
2020-05-02,1087,1086,720,8,353,0,5,66713,66572,0,
2020-05-03,1039,1037,661,6,363,5,2,67752,67609,0,
2020-05-04,1319,1319,802,6,507,1,3,69071,68928,0,
2020-05-05,1258,1257,781,6,466,1,3,70329,70185,0,
2020-05-06,1094,1093,675,8,403,2,5,71423,71278,0,
2020-05-07,1122,1122,721,6,388,6,1,72545,72400,0,
2020-05-08,1162,1160,728,5,419,1,7,73707,73560,0,
2020-05-09,1037,1037,688,9,332,4,4,74744,74597,0,
2020-05-10,977,977,636,6,329,4,2,75721,75574,0,
2020-05-11,1232,1232,791,5,420,6,10,76953,76806,0,
2020-05-12,1086,1086,716,6,353,6,5,78039,77892,0,
2020-05-13,1096,1095,714,3,375,2,1,79135,78987,0,
2020-05-14,1156,1156,760,3,383,6,4,80291,80143,0,
2020-05-15,1272,1272,814,0,443,11,4,81563,81415,0,
2020-05-16,997,997,656,2,337,1,1,82560,82412,0,
2020-05-17,919,918,608,2,299,8,1,83479,83330,0,
2020-05-18,1078,1077,662,2,406,5,2,84557,84407,0,
2020-05-19,940,940,626,3,306,3,2,85497,85347,0,
2020-05-20,1095,1094,703,1,387,1,2,86592,86441,0,
2020-05-21,870,870,595,3,264,5,3,87462,87311,0,
2020-05-22,845,844,539,0,299,4,2,88307,88155,0,
2020-05-23,704,704,477,1,222,4,0,89011,88859,0,
2020-05-24,643,643,437,0,201,4,1,89654,89502,0,
2020-05-25,828,828,525,3,291,3,6,90482,90330,0,
2020-05-26,721,721,494,1,218,6,2,91203,91051,0,
2020-05-27,714,714,485,2,225,2,0,91917,91765,0,
2020-05-28,577,577,391,2,183,1,0,92494,92342,0,
2020-05-29,695,695,457,0,233,4,1,93189,93037,0,
2020-05-30,559,555,406,2,144,1,2,93748,93592,0,
2020-05-31,434,433,304,0,125,4,0,94182,94025,0,
2020-06-01,663,662,458,5,193,5,1,94845,94687,0,
2020-06-02,497,495,346,1,140,6,2,95342,95182,0,
2020-06-03,485,485,331,3,147,3,1,95827,95667,0,
2020-06-04,452,451,297,1,141,11,1,96279,96118,0,
2020-06-05,445,441,318,1,119,3,0,96724,96559,0,
2020-06-06,370,368,266,1,96,5,0,97094,96927,0,
2020-06-07,319,317,237,1,78,1,0,97413,97244,0,
2020-06-08,406,401,281,6,98,11,5,97819,97645,0,
2020-06-09,371,369,259,3,102,4,1,98190,98014,0,
2020-06-10,433,432,294,4,119,10,5,98623,98446,0,
2020-06-11,360,357,246,3,103,5,0,98983,98803,0,
2020-06-12,374,369,240,5,115,6,3,99357,99172,0,
2020-06-13,268,267,173,2,86,5,1,99625,99439,0,
2020-06-14,302,299,205,0,83,9,2,99927,99738,0,
2020-06-15,388,388,248,4,124,7,5,100315,100126,0,
2020-06-16,354,352,238,2,100,9,3,100669,100478,0,
2020-06-17,341,340,232,0,97,5,6,101010,100818,0,
2020-06-18,302,300,203,1,90,5,1,101312,101118,0,
2020-06-19,332,332,238,0,80,10,4,101644,101450,0,
2020-06-20,282,280,201,0,64,9,6,101926,101730,0,
2020-06-21,272,271,175,0,88,5,3,102198,102001,0,
2020-06-22,334,329,218,2,101,4,4,102532,102330,0,
2020-06-23,318,317,211,2,94,7,3,102850,102647,0,
2020-06-24,279,278,186,2,81,7,2,103129,102925,0,
2020-06-25,389,387,283,1,97,5,1,103518,103312,0,
2020-06-26,261,257,153,1,88,10,5,103779,103569,0,
2020-06-27,269,268,196,1,63,7,1,104048,103837,0,
2020-06-28,270,268,184,1,75,8,0,104318,104105,0,
2020-06-29,317,314,206,2,91,9,6,104635,104419,0,
2020-06-30,290,285,190,3,87,2,3,104925,104704,0,
2020-07-01,276,264,162,8,88,5,1,105201,104968,0,
2020-07-02,253,246,164,1,71,6,4,105454,105214,0,
2020-07-03,283,275,173,2,89,11,0,105737,105489,0,
2020-07-04,285,273,160,3,99,10,1,106022,105762,0,
2020-07-05,268,266,161,3,94,7,1,106290,106028,0,
2020-07-06,472,462,255,2,162,16,27,106762,106490,0,
2020-07-07,422,411,232,5,150,20,4,107184,106901,0,
2020-07-08,427,403,262,4,121,11,5,107611,107304,0,
2020-07-09,401,381,247,4,114,12,4,108012,107685,0,
2020-07-10,386,370,248,6,98,13,5,108398,108055,0,
2020-07-11,364,350,208,3,121,12,6,108762,108405,0,
2020-07-12,380,359,229,3,123,4,0,109142,108764,0,
2020-07-13,601,551,341,12,179,13,6,109743,109315,0,
2020-07-14,527,488,287,4,177,12,8,110270,109803,0,
2020-07-15,547,501,306,3,174,12,6,110817,110304,0,
2020-07-16,444,407,240,3,142,20,2,111261,110711,0,
2020-07-17,476,441,257,6,168,5,5,111737,111152,0,
2020-07-18,398,369,234,2,123,9,1,112135,111521,0,
2020-07-19,372,334,198,4,119,10,3,112507,111855,0,
2020-07-20,520,460,259,6,185,9,1,113027,112315,0,
2020-07-21,481,422,244,9,157,6,6,113508,112737,0,
2020-07-22,433,381,189,7,172,10,3,113941,113118,0,
2020-07-23,398,319,146,3,158,8,4,114339,113437,0,
2020-07-24,400,314,161,7,137,5,4,114739,113751,0,
2020-07-25,294,206,100,4,94,5,3,115033,113957,0,
2020-07-26,308,202,115,6,69,11,1,115341,114159,0,
2020-07-27,445,302,167,4,113,11,7,115786,114461,0,
2020-07-28,357,242,132,1,93,12,4,116143,114703,0,
2020-07-29,367,210,127,1,72,4,6,116510,114913,0,
2020-07-30,299,191,101,1,71,6,12,116809,115104,0,
2020-07-31,300,184,102,0,69,8,5,117109,115288,0,
2020-08-01,305,179,99,7,54,17,2,117414,115467,0,
2020-08-02,286,170,93,7,62,6,2,117700,115637,0,
2020-08-03,378,242,134,2,91,12,3,118078,115879,0,
2020-08-04,387,261,138,0,99,16,8,118465,116140,0,
2020-08-05,355,258,146,9,91,6,6,118820,116398,0,
2020-08-06,320,235,139,5,78,6,7,119140,116633,0,
2020-08-07,351,258,144,2,95,7,10,119491,116891,0,
2020-08-08,310,195,97,4,76,2,16,119801,117086,0,
2020-08-09,302,217,104,7,93,6,7,120103,117303,0,
2020-08-10,395,301,146,7,128,9,11,120498,117604,0,
2020-08-11,392,307,161,5,129,8,4,120890,117911,0,
2020-08-12,363,270,146,12,95,11,6,121253,118181,0,
2020-08-13,350,288,167,6,102,9,4,121603,118469,0,
2020-08-14,322,239,109,8,107,6,9,121925,118708,0,
2020-08-15,334,241,102,7,120,4,8,122259,118949,1,
2020-08-16,354,238,114,14,104,4,2,122613,119187,0,
2020-08-17,478,337,175,9,139,7,7,123091,119524,0,
2020-08-18,381,292,151,4,130,3,4,123472,119816,0,
2020-08-19,396,288,151,8,120,3,6,123868,120104,0,
2020-08-20,397,302,157,7,128,4,6,124265,120406,0,
2020-08-21,383,286,147,9,120,5,5,124648,120692,0,
2020-08-22,380,304,167,8,121,4,4,125028,120996,0,
2020-08-23,371,269,134,2,123,4,6,125399,121265,0,
2020-08-24,524,379,188,15,166,6,4,125923,121644,0,
2020-08-25,550,418,205,12,182,9,10,126473,122062,0,
2020-08-26,522,370,186,14,160,4,6,126995,122432,0,
2020-08-27,426,315,168,11,133,2,1,127421,122747,0,
2020-08-28,511,378,201,11,154,6,6,127932,123125,0,
2020-08-29,402,285,157,10,112,4,2,128334,123410,0,
2020-08-30,491,355,189,4,148,7,7,128825,123765,0,
2020-08-31,580,380,207,10,147,8,8,129405,124145,0,
2020-09-01,667,460,260,17,173,5,5,130072,124605,0,
2020-09-02,640,429,243,13,160,6,7,130712,125034,0,
2020-09-03,570,396,218,5,160,3,10,131282,125430,0,
2020-09-04,652,431,224,10,182,9,6,131934,125861,0,
2020-09-05,585,374,214,8,140,9,3,132519,126235,0,
2020-09-06,612,385,212,4,155,7,7,133131,126620,0,
2020-09-07,735,474,243,10,203,9,9,133866,127094,0,
2020-09-08,868,569,306,11,227,11,14,134734,127663,0,
2020-09-09,866,550,307,11,218,3,11,135600,128213,0,
2020-09-10,841,542,294,7,221,5,15,136441,128755,0,
2020-09-11,843,554,299,10,226,10,9,137284,129309,0,
2020-09-12,909,605,324,9,257,4,11,138193,129914,0,
2020-09-13,841,559,281,8,252,5,13,139034,130473,0,
2020-09-14,1128,737,391,14,303,8,21,140162,131210,0,
2020-09-15,1181,781,438,10,313,4,16,141343,131991,0,
2020-09-16,1163,744,426,22,276,3,17,142506,132735,0,
2020-09-17,1105,704,389,21,263,7,24,143611,133439,0,
2020-09-18,1182,729,409,8,275,1,36,144793,134168,0,
2020-09-19,1108,678,333,18,287,3,37,145901,134846,0,
2020-09-20,1118,666,318,11,289,7,41,147019,135512,0,
2020-09-21,1481,968,473,16,381,5,93,148500,136480,0,
2020-09-22,1443,899,429,15,334,5,116,149943,137379,0,
2020-09-23,1442,921,478,14,311,2,116,151385,138300,0,
2020-09-24,1490,935,439,10,328,2,156,152875,139235,0,
2020-09-25,1603,1021,465,20,343,7,186,154478,140256,0,
2020-09-26,1436,844,387,7,268,3,179,155914,141100,0,
2020-09-27,1460,889,371,12,295,5,206,157374,141989,0,
2020-09-28,1853,1092,454,15,366,3,254,159227,143081,0,
2020-09-29,1628,1028,475,20,323,2,208,160855,144109,0,
2020-09-30,1589,1014,432,16,339,1,226,162444,145123,0,
2020-10-01,1504,972,437,7,325,5,198,163948,146095,0,
2020-10-02,1517,978,428,19,332,4,195,165465,147073,0,
2020-10-03,1297,855,383,18,289,5,160,166762,147928,0,
2020-10-04,1264,836,381,13,294,4,144,168026,148764,0,
2020-10-05,1528,1088,510,13,352,3,210,169554,149852,0,
2020-10-06,1408,1067,501,27,329,3,207,170962,150919,0,
2020-10-07,1305,1004,470,13,313,6,202,172267,151923,0,
2020-10-08,1088,880,408,8,283,4,177,173355,152803,0,
2020-10-09,1064,909,409,15,261,2,222,174419,153712,0,
2020-10-10,930,829,371,8,250,1,199,175349,154541,0,
2020-10-11,762,710,302,5,223,3,177,176111,155251,0,
2020-10-12,756,704,302,2,199,1,200,176867,155955,0,
2020-10-13,822,766,305,4,243,1,213,177689,156721,0,
2020-10-14,721,667,275,0,199,0,193,178410,157388,,
2020-10-15,692,655,245,1,171,2,236,179102,158043,,
2020-10-16,625,591,207,2,141,1,240,179727,158634,,
2020-10-17,471,438,129,1,100,1,207,180198,159072,,
2020-10-18,408,389,92,0,87,0,210,180606,159461,,
2020-10-19,444,438,58,0,160,0,220,181050,159899,,
2020-10-20,101,98,9,0,39,0,50,181151,159997,,
2020-10-21,2,0,0,0,0,0,0,181153,159997,,
2020-10-22,0,0,0,0,0,0,0,181153,159997,,