date,new,NTotal_ExposureOnly,domestic-contactWithCase,domestic-contactWithTraveller,domestic-unknown,internationalTravel,infopending,cumulative,cumulativeNTotal_ExposureOnly,doubleFlagTest,shaded
2020-01-15,1,1,0,0,0,1,0,1,1,1,14
2020-01-16,2,2,1,0,0,0,1,3,3,1,
2020-01-17,0,0,0,0,0,0,0,3,3,0,
2020-01-18,0,0,0,0,0,0,0,3,3,0,
2020-01-19,0,0,0,0,0,0,0,3,3,0,
2020-01-20,0,0,0,0,0,0,0,3,3,0,
2020-01-21,1,1,0,0,0,1,0,4,4,0,
2020-01-22,2,2,0,0,0,2,0,6,6,1,
2020-01-23,0,0,0,0,0,0,0,6,6,0,
2020-01-24,2,2,1,0,0,1,0,8,8,0,
2020-01-25,0,0,0,0,0,0,0,8,8,0,
2020-01-26,1,1,1,0,0,0,0,9,9,0,
2020-01-27,2,2,2,0,0,0,0,11,11,0,
2020-01-28,2,2,0,0,1,1,0,13,13,1,
2020-01-29,0,0,0,0,0,0,0,13,13,0,
2020-01-30,0,0,0,0,0,0,0,13,13,0,
2020-01-31,1,1,0,0,1,0,0,14,14,0,
2020-02-01,2,2,0,0,1,1,0,16,16,0,
2020-02-02,2,1,0,0,0,1,0,18,17,0,
2020-02-03,1,1,0,0,1,0,0,19,18,0,
2020-02-04,2,2,0,0,2,0,0,21,20,0,
2020-02-05,2,2,0,0,1,1,0,23,22,0,
2020-02-06,0,0,0,0,0,0,0,23,22,0,
2020-02-07,1,1,1,0,0,0,0,24,23,0,
2020-02-08,0,0,0,0,0,0,0,24,23,0,
2020-02-09,1,1,0,0,0,1,0,25,24,0,
2020-02-10,2,2,0,0,1,1,0,27,26,1,
2020-02-11,1,0,0,0,0,0,0,28,26,0,
2020-02-12,1,1,0,0,1,0,0,29,27,0,
2020-02-13,1,1,0,0,0,1,0,30,28,0,
2020-02-14,4,4,0,0,2,2,0,34,32,0,
2020-02-15,2,2,1,0,0,1,0,36,34,0,
2020-02-16,1,1,0,0,0,1,0,37,35,0,
2020-02-17,2,2,1,0,0,1,0,39,37,0,
2020-02-18,2,2,2,0,0,0,0,41,39,0,
2020-02-19,3,3,1,0,1,1,0,44,42,0,
2020-02-20,7,7,3,1,1,2,0,51,49,0,
2020-02-21,2,2,0,0,0,2,0,53,51,0,
2020-02-22,5,5,0,0,2,3,0,58,56,1,
2020-02-23,16,16,7,0,2,7,0,74,72,0,
2020-02-24,14,14,3,0,2,9,0,88,86,0,
2020-02-25,15,15,3,0,2,10,0,103,101,0,
2020-02-26,12,12,6,1,3,2,0,115,113,0,
2020-02-27,25,25,13,0,7,5,0,140,138,1,
2020-02-28,35,35,19,0,5,11,0,175,173,0,
2020-02-29,27,27,9,0,4,13,1,202,200,0,
2020-03-01,49,48,13,0,15,19,1,251,248,0,
2020-03-02,47,47,8,0,11,28,0,298,295,1,
2020-03-03,53,53,17,0,8,28,0,351,348,0,
2020-03-04,51,50,16,1,8,25,0,402,398,0,
2020-03-05,63,63,14,1,17,31,0,465,461,0,
2020-03-06,83,83,18,2,22,40,1,548,544,0,
2020-03-07,89,89,17,3,27,42,0,637,633,1,
2020-03-08,131,131,33,3,35,58,2,768,764,0,
2020-03-09,224,224,69,10,56,89,0,992,988,0,
2020-03-10,260,260,65,9,64,121,1,1252,1248,0,
2020-03-11,295,295,86,10,73,121,5,1547,1543,1,
2020-03-12,388,386,107,8,119,150,2,1935,1929,0,
2020-03-13,456,452,136,10,140,165,1,2391,2381,0,
2020-03-14,466,461,101,14,161,182,3,2857,2842,0,
2020-03-15,600,597,169,11,193,220,4,3457,3439,1,
2020-03-16,832,828,270,10,290,256,2,4289,4267,0,
2020-03-17,880,876,280,17,299,274,6,5169,5143,0,
2020-03-18,950,942,290,19,335,289,9,6119,6085,0,
2020-03-19,807,804,271,12,280,232,9,6926,6889,1,
2020-03-20,1022,1014,377,23,387,222,5,7948,7903,0,
2020-03-21,883,881,327,11,300,236,7,8831,8784,0,
2020-03-22,869,866,343,13,317,188,5,9700,9650,0,
2020-03-23,1065,1058,459,17,409,165,8,10765,10708,0,
2020-03-24,954,951,406,21,353,167,4,11719,11659,0,
2020-03-25,970,968,464,13,371,113,7,12689,12627,0,
2020-03-26,910,903,456,14,323,104,6,13599,13530,0,
2020-03-27,947,938,494,8,349,78,9,14546,14468,1,
2020-03-28,950,943,522,8,326,82,5,15496,15411,0,
2020-03-29,861,858,498,9,295,52,4,16357,16269,0,
2020-03-30,1135,1131,636,11,411,69,4,17492,17400,0,
2020-03-31,966,956,570,3,314,64,5,18458,18356,0,
2020-04-01,1286,1283,812,13,371,80,7,19744,19639,0,
2020-04-02,1162,1159,811,11,292,41,4,20906,20798,0,
2020-04-03,1327,1326,951,7,316,51,1,22233,22124,0,
2020-04-04,1146,1145,834,9,264,31,7,23379,23269,0,
2020-04-05,1069,1064,752,5,282,20,5,24448,24333,0,
2020-04-06,1402,1400,947,11,423,13,6,25850,25733,0,
2020-04-07,1275,1275,870,13,371,18,3,27125,27008,0,
2020-04-08,1409,1405,985,10,399,5,6,28534,28413,0,
2020-04-09,1459,1458,1017,14,421,5,1,29993,29871,1,
2020-04-10,1740,1736,1234,19,469,6,8,31733,31607,0,
2020-04-11,1625,1622,1126,11,480,3,2,33358,33229,0,
2020-04-12,1479,1477,1052,16,397,5,7,34837,34706,0,
2020-04-13,2038,2037,1284,32,708,6,7,36875,36743,0,
2020-04-14,1781,1778,1213,21,539,3,2,38656,38521,0,
2020-04-15,1871,1869,1328,21,510,4,6,40527,40390,0,
2020-04-16,1940,1939,1304,18,613,1,3,42467,42329,0,
2020-04-17,1869,1868,1316,17,532,3,0,44336,44197,0,
2020-04-18,1665,1663,1203,21,435,3,1,46001,45860,0,
2020-04-19,1278,1276,873,15,379,4,5,47279,47136,0,
2020-04-20,1790,1788,1204,11,565,3,5,49069,48924,0,
2020-04-21,1439,1438,925,13,491,4,5,50508,50362,0,
2020-04-22,1549,1548,1003,12,527,2,4,52057,51910,0,
2020-04-23,1575,1574,1013,20,537,1,3,53632,53484,0,
2020-04-24,1510,1505,975,10,513,3,4,55142,54989,0,
2020-04-25,1401,1400,934,15,442,5,4,56543,56389,0,
2020-04-26,1351,1349,895,13,431,4,6,57894,57738,0,
2020-04-27,1674,1674,1045,11,610,5,3,59568,59412,0,
2020-04-28,1529,1528,981,19,518,6,4,61097,60940,1,
2020-04-29,1492,1492,897,4,583,2,6,62589,62432,0,
2020-04-30,1441,1440,888,5,541,3,3,64030,63872,0,
2020-05-01,1593,1586,961,8,610,4,3,65623,65458,0,
2020-05-02,1075,1074,713,8,348,0,5,66698,66532,0,
2020-05-03,1045,1044,661,6,370,5,2,67743,67576,0,
2020-05-04,1325,1322,804,6,508,1,3,69068,68898,0,
2020-05-05,1256,1254,783,6,461,1,3,70324,70152,0,
2020-05-06,1090,1090,669,8,406,2,5,71414,71242,0,
2020-05-07,1124,1121,720,6,388,6,1,72538,72363,0,
2020-05-08,1148,1148,721,5,414,1,7,73686,73511,0,
2020-05-09,1042,1040,691,9,332,4,4,74728,74551,0,
2020-05-10,987,987,643,6,332,4,2,75715,75538,0,
2020-05-11,1224,1224,784,5,419,6,10,76939,76762,0,
2020-05-12,1098,1096,730,6,349,6,5,78037,77858,0,
2020-05-13,1089,1089,703,3,380,2,1,79126,78947,0,
2020-05-14,1174,1172,776,3,382,6,5,80300,80119,0,
2020-05-15,1280,1280,823,0,442,11,4,81580,81399,0,
2020-05-16,985,982,642,2,336,1,1,82565,82381,0,
2020-05-17,918,914,600,2,303,8,1,83483,83295,0,
2020-05-18,1078,1076,663,2,404,5,2,84561,84371,0,
2020-05-19,943,942,623,3,311,3,2,85504,85313,0,
2020-05-20,1092,1091,711,1,376,1,2,86596,86404,0,
2020-05-21,855,853,581,3,261,5,3,87451,87257,0,
2020-05-22,850,849,540,0,303,4,2,88301,88106,0,
2020-05-23,714,714,482,1,225,6,0,89015,88820,0,
2020-05-24,646,645,438,0,204,2,1,89661,89465,0,
2020-05-25,830,829,541,3,276,3,6,90491,90294,0,
2020-05-26,727,724,489,1,225,7,2,91218,91018,0,
2020-05-27,694,690,467,2,220,1,0,91912,91708,0,
2020-05-28,587,583,396,2,184,1,0,92499,92291,0,
2020-05-29,692,691,459,0,227,4,1,93191,92982,0,
2020-05-30,548,541,389,2,147,1,2,93739,93523,0,
2020-05-31,483,482,353,0,125,4,0,94222,94005,0,
2020-06-01,612,609,406,5,192,5,1,94834,94614,0,
2020-06-02,495,493,342,1,141,6,3,95329,95107,0,
2020-06-03,510,509,354,3,148,3,1,95839,95616,0,
2020-06-04,434,429,274,1,142,11,1,96273,96045,0,
2020-06-05,430,424,307,1,113,3,0,96703,96469,0,
2020-06-06,387,381,281,1,94,5,0,97090,96850,0,
2020-06-07,325,320,236,1,82,1,0,97415,97170,0,
2020-06-08,395,390,275,6,94,11,4,97810,97560,0,
2020-06-09,359,357,245,3,103,5,1,98169,97917,0,
2020-06-10,421,419,288,4,113,9,5,98590,98336,0,
2020-06-11,363,358,244,3,105,6,0,98953,98694,0,
2020-06-12,371,367,241,5,113,5,3,99324,99061,0,
2020-06-13,274,270,175,2,86,6,1,99598,99331,0,
2020-06-14,304,302,208,0,84,8,2,99902,99633,0,
2020-06-15,388,386,247,4,122,7,6,100290,100019,0,
2020-06-16,354,350,236,2,100,9,3,100644,100369,0,
2020-06-17,346,344,232,0,98,5,9,100990,100713,0,
2020-06-18,309,307,205,1,93,5,3,101299,101020,0,
2020-06-19,329,327,236,0,79,10,2,101628,101347,0,
2020-06-20,286,284,207,0,67,9,1,101914,101631,0,
2020-06-21,275,272,176,0,88,5,3,102189,101903,0,
2020-06-22,334,328,216,2,101,5,4,102523,102231,0,
2020-06-23,317,315,210,2,94,6,3,102840,102546,0,
2020-06-24,278,277,185,2,81,7,2,103118,102823,0,
2020-06-25,388,387,283,1,97,5,1,103506,103210,0,
2020-06-26,263,257,153,1,88,10,5,103769,103467,0,
2020-06-27,269,268,198,1,61,7,1,104038,103735,0,
2020-06-28,273,270,186,1,75,8,0,104311,104005,0,
2020-06-29,317,311,202,2,92,9,6,104628,104316,0,
2020-06-30,294,289,195,3,87,2,2,104922,104605,0,
2020-07-01,275,264,162,8,88,5,1,105197,104869,0,
2020-07-02,257,246,163,1,72,6,4,105454,105115,0,
2020-07-03,286,277,173,2,90,11,1,105740,105392,0,
2020-07-04,288,276,163,3,98,11,1,106028,105668,0,
2020-07-05,273,267,164,3,94,5,1,106301,105935,0,
2020-07-06,474,463,254,2,161,19,27,106775,106398,0,
2020-07-07,420,410,235,5,149,18,3,107195,106808,0,
2020-07-08,429,404,261,4,123,11,5,107624,107212,0,
2020-07-09,398,382,248,4,115,11,4,108022,107594,0,
2020-07-10,397,374,251,6,100,12,5,108419,107968,0,
2020-07-11,369,354,211,3,121,12,7,108788,108322,0,
2020-07-12,384,359,228,3,124,4,0,109172,108681,0,
2020-07-13,600,551,339,12,180,14,6,109772,109232,0,
2020-07-14,541,491,288,4,181,12,6,110313,109723,0,
2020-07-15,547,502,308,3,172,13,6,110860,110225,0,
2020-07-16,450,410,240,3,146,19,2,111310,110635,0,
2020-07-17,481,442,259,6,168,4,5,111791,111077,0,
2020-07-18,396,366,232,2,122,9,1,112187,111443,0,
2020-07-19,379,337,200,4,119,11,3,112566,111780,0,
2020-07-20,521,458,260,6,184,7,1,113087,112238,0,
2020-07-21,483,424,244,9,158,7,6,113570,112662,0,
2020-07-22,444,382,187,7,174,11,3,114014,113044,0,
2020-07-23,402,318,149,3,156,7,3,114416,113362,0,
2020-07-24,415,318,164,7,138,5,4,114831,113680,0,
2020-07-25,304,207,100,4,94,6,3,115135,113887,0,
2020-07-26,327,202,116,6,69,10,1,115462,114089,0,
2020-07-27,461,302,170,4,112,12,4,115923,114391,0,
2020-07-28,398,242,133,1,93,11,4,116321,114633,0,
2020-07-29,377,210,126,1,73,4,6,116698,114843,0,
2020-07-30,330,190,104,1,70,7,8,117028,115033,0,
2020-07-31,316,183,104,0,68,7,4,117344,115216,0,
2020-08-01,321,180,99,7,54,17,3,117665,115396,0,
2020-08-02,323,171,93,7,61,8,2,117988,115567,0,
2020-08-03,424,245,137,2,92,11,3,118412,115812,0,
2020-08-04,410,261,137,0,99,15,10,118822,116073,0,
2020-08-05,365,259,145,9,93,7,5,119187,116332,0,
2020-08-06,349,233,139,5,77,5,7,119536,116565,0,
2020-08-07,373,258,146,2,93,7,10,119909,116823,0,
2020-08-08,319,194,99,4,74,2,15,120228,117017,0,
2020-08-09,305,218,105,7,93,6,7,120533,117235,0,
2020-08-10,426,303,147,7,127,11,11,120959,117538,0,
2020-08-11,439,311,164,5,131,7,4,121398,117849,0,
2020-08-12,358,273,146,12,95,11,9,121756,118122,0,
2020-08-13,384,292,170,6,102,10,4,122140,118414,0,
2020-08-14,347,238,115,8,107,5,3,122487,118652,1,
2020-08-15,349,239,102,7,119,4,7,122836,118891,0,
2020-08-16,367,237,113,14,104,4,2,123203,119128,0,
2020-08-17,488,339,177,9,139,8,6,123691,119467,0,
2020-08-18,396,292,153,4,129,2,4,124087,119759,0,
2020-08-19,417,289,151,8,120,4,6,124504,120048,0,
2020-08-20,414,302,157,7,128,3,7,124918,120350,0,
2020-08-21,394,286,149,9,118,5,5,125312,120636,0,
2020-08-22,393,304,168,8,119,5,4,125705,120940,0,
2020-08-23,383,269,134,2,123,4,6,126088,121209,0,
2020-08-24,534,380,188,15,167,7,3,126622,121589,0,
2020-08-25,575,414,205,12,179,8,10,127197,122003,0,
2020-08-26,534,369,188,14,158,4,5,127731,122372,0,
2020-08-27,448,316,168,11,134,2,1,128179,122688,0,
2020-08-28,535,375,200,11,152,6,6,128714,123063,0,
2020-08-29,424,287,157,10,112,5,3,129138,123350,0,
2020-08-30,515,355,190,4,147,7,7,129653,123705,0,
2020-08-31,612,379,209,10,145,7,8,130265,124084,0,
2020-09-01,716,461,261,17,173,5,5,130981,124545,0,
2020-09-02,673,430,244,13,160,6,7,131654,124975,0,
2020-09-03,608,395,219,5,158,3,10,132262,125370,0,
2020-09-04,687,432,231,10,176,9,6,132949,125802,0,
2020-09-05,644,376,218,8,138,9,3,133593,126178,0,
2020-09-06,657,390,217,4,155,7,7,134250,126568,0,
2020-09-07,770,476,247,10,201,9,9,135020,127044,0,
2020-09-08,930,569,312,11,222,12,12,135950,127613,0,
2020-09-09,942,555,316,11,215,2,11,136892,128168,0,
2020-09-10,903,547,301,7,218,6,15,137795,128715,0,
2020-09-11,899,558,305,10,225,9,9,138694,129273,0,
2020-09-12,964,610,332,9,255,4,10,139658,129883,0,
2020-09-13,941,559,287,8,248,5,11,140599,130442,0,
2020-09-14,1207,738,401,14,298,8,17,141806,131180,0,
2020-09-15,1298,788,442,10,315,5,16,143104,131968,0,
2020-09-16,1291,752,431,21,276,4,20,144395,132720,0,
2020-09-17,1226,701,394,21,257,6,23,145621,133421,0,
2020-09-18,1352,742,424,8,277,1,32,146973,134163,0,
2020-09-19,1238,691,346,18,290,5,32,148211,134854,0,
2020-09-20,1264,670,321,11,289,8,41,149475,135524,0,
2020-09-21,1750,980,494,16,382,5,83,151225,136504,0,
2020-09-22,1797,914,453,15,341,8,97,153022,137418,0,
2020-09-23,1814,925,488,14,322,1,100,154836,138343,0,
2020-09-24,1858,930,455,10,344,4,117,156694,139273,0,
2020-09-25,2006,1022,491,20,348,5,158,158700,140295,0,
2020-09-26,1787,860,414,7,277,5,157,160487,141155,0,
2020-09-27,1896,910,399,12,317,4,178,162383,142065,0,
2020-09-28,2355,1117,493,15,386,4,219,164738,143182,0,
2020-09-29,2202,1060,518,21,336,2,183,166940,144242,0,
2020-09-30,2203,1036,462,17,350,1,206,169143,145278,0,
2020-10-01,2077,994,459,8,331,10,186,171220,146272,0,
2020-10-02,2074,1022,470,18,354,7,173,173294,147294,0,
2020-10-03,1782,885,408,19,299,5,154,175076,148179,0,
2020-10-04,1856,880,424,14,302,7,133,176932,149059,0,
2020-10-05,2334,1185,588,18,375,3,201,179266,150244,0,
2020-10-06,2213,1152,565,30,359,10,188,181479,151396,0,
2020-10-07,2179,1150,597,18,340,7,188,183658,152546,0,
2020-10-08,2121,1040,520,14,324,6,176,185779,153586,0,
2020-10-09,2208,1111,528,20,346,5,212,187987,154697,0,
2020-10-10,2006,1127,537,15,364,3,208,189993,155824,0,
2020-10-11,1843,1009,487,19,324,4,175,191836,156833,0,
2020-10-12,2205,1172,551,21,357,9,234,194041,158005,0,
2020-10-13,2521,1373,636,22,462,6,247,196562,159378,0,
2020-10-14,2443,1353,699,24,420,5,205,199005,160731,,
2020-10-15,2448,1268,679,23,378,9,179,201453,161999,,
2020-10-16,2516,1398,754,21,406,5,212,203969,163397,,
2020-10-17,2257,1229,657,21,356,4,191,206226,164626,,
2020-10-18,2196,1250,626,14,386,9,215,208422,165876,,
2020-10-19,2756,1604,800,21,510,5,268,211178,167480,,
2020-10-20,2627,1580,813,26,476,4,261,213805,169060,,
2020-10-21,2641,1537,806,32,418,9,272,216446,170597,,
2020-10-22,2523,1478,764,21,443,1,249,218969,172075,,
2020-10-23,2547,1494,792,20,430,7,245,221516,173569,,
2020-10-24,2300,1381,739,28,385,6,223,223816,174950,,
2020-10-25,2234,1288,696,29,363,3,197,226050,176238,,
2020-10-26,2764,1596,828,15,493,4,256,228814,177834,,
2020-10-27,2515,1528,796,21,438,5,268,231329,179362,,
2020-10-28,2462,1535,843,20,401,5,266,233791,180897,,
2020-10-29,1952,1164,611,4,318,1,230,235743,182061,,
2020-10-30,1810,1107,570,8,282,1,246,237553,183168,,
2020-10-31,1364,1004,496,4,246,1,257,238917,184172,,
2020-11-01,853,790,362,3,196,1,228,239770,184962,,
2020-11-02,1164,1073,528,0,218,1,326,240934,186035,,
2020-11-03,1007,937,347,1,205,0,384,241941,186972,,
2020-11-04,879,829,278,0,170,0,381,242820,187801,,
2020-11-05,701,690,148,0,149,0,393,243521,188491,,
2020-11-06,717,717,100,0,159,0,458,244238,189208,,
2020-11-07,147,146,9,0,43,0,94,244385,189354,,
2020-11-08,0,0,0,0,0,0,0,244385,189354,,
2020-11-09,0,0,0,0,0,0,0,244385,189354,,